20, 20
11111111111111111111
12004401111100670111
10011141167106000151
10000100001117011101
10111111104444055101
10000001000100115101
10111111000111111101
10040010000706040601
10044011116000040001
10040400010050040001
10040040115550444001
10045044115006040071
10055570111116000071
11111110055501111001
11100406040451441101
11170401004051415101
11160401044451416701
11114441004051441101
11111111111100004131
11111111111111111111