15, 15
111111111111111
100030000000001
100000030000301
100003000000001
100003000000301
100300030000001
100000000000001
100000400030001
100300000000001
100000000030001
100000000030001
100000003000001
100030000000001
103000003003001
111111111111111