20, 20
12110001111111111101
10010011111111111111
10011101111111111111
10000100001111111101
10111111100000000101
10000001000100110101
00111111000111111101
00000010000000000001
00000011110000000001
00000000010000000001
00000000110000000001
00000000110000000001
00000000111111000001
01111110000001111001
01100001000001111101
01100001000001110101
01100001000001110001
01110001000001111101
01111111111111111101
00000000000000003000