20, 20
11111111111111111111
12004401111100000111
10011141111100000111
10000100001110011101
10111111104444000101
10000001000100110101
10111111000111111101
10040010000000040001
10044011110000040001
10040400010000040001
10040040110000444001
10040044110000040001
10000000111111000001
11111110000001111001
11100400040401441101
11100401004001410101
11100401044401410001
11114441004001441101
11111111111100004131
11111111111111111111